Alemanha	Europa
Bélgica	Europa
Bósnia e Herzegovina	Europa
Croácia	Europa
Espanha	Europa
França	Europa
Grécia	Europa
Holanda	Europa
Inglaterra	Europa
Itália	Europa
Portugal	Europa
Rússia	Europa
Suíça	Europa
Argélia	África
Camarões	África
Costa do Marfim	África
Gana	África
Nigéria	África
Austrália	Ásia
Irã	Ásia
Japão	Ásia
Coréia do Sul	Ásia
Costa Rica	América do Norte, Central e Caribe
Estados Unidos	América do Norte, Central e Caribe
Honduras	América do Norte, Central e Caribe
México	América do Norte, Central e Caribe
Argentina	América do Sul
Brasil	América do Sul
Chile	América do Sul
Colômbia	América do Sul
Equador	América do Sul
Uruguai	América do Sul
Kuwait	-
Qatar	-
Emirados Árabes	-
Arábia Saudita	-
Canadá	-
Escócia	-
Dinamarca	-
Noruega	-
Suécia	-
Áustria	-
Hungria	-
Ucrânia	-
Tunísia	-
Turquia	-
China	-
Israel	-